A New Project
An Interactive Fiction by Michael Gray
Release 1 / Serial number 231031 / Inform 7 v10.1.2 / D

Front Yard
A large tree sits off on the right side of the yard.

>dsf
That's not a verb I recognise.

* * *

A New Project
An Interactive Fiction by Michael Gray
Release 1 / Serial number 231031 / Inform 7 v10.1.2 / D

Front Yard
A large tree sits off on the right side of the yard.

>i
You are carrying nothing.

>look
Beach

* * *

A New Project
An Interactive Fiction by Michael Gray
Release 1 / Serial number 231031 / Inform 7 v10.1.2 / D

Front Yard
A large tree sits off on the right side of the yard.

>norht
That's not a verb I recognise.

>north
Front Porch
A welcome mat sits at the foot of the front door.

You can also see a Front Door here.

>open welcome mat
It isn't something you can open.

>look at welcome mat
In the welcome mat is a house key.

>pick up
What do you want to pick up?

>house key
Taken.

>i
You are carrying:
  a house key

* * *

A New Project
An Interactive Fiction by Michael Gray
Release 1 / Serial number 231031 / Inform 7 v10.1.2 / D

Front Yard
A large tree sits off on the right side of the yard.

>north
Front Porch
A welcome mat sits at the foot of the front door.

You can also see a Front Door here.

>look under welcome mat
You find nothing of interest.

>look
Front Porch
A welcome mat sits at the foot of the front door.

You can also see a Front Door here.

>look at welcome mat
In the welcome mat is a house key.

* * *

>north
Front Porch
A welcome mat sits at the foot of the front door.

You can also see a Front Door here.

>norht
That's not a verb I recognise.

>north
You can't go that way.

>look
Th Front Porch

* * *

>north
Front Porch
A welcome mat sits at the foot of the front door.

You can also see a Front Door here.

>north
(first opening the Front Door)
It seems to be locked.

>unlock
(the Front Door with the Front Door)
(first taking the Front Door)
That's fixed in place.

* * *

>north
Front Porch
A welcome mat sits at the foot of the front door.

You can also see a Front Door here.

>pick up key
Taken.

>in
You can't go that way.

>i
You are carrying:
  a house key

>unlock door
(with the house key)
You unlock the Front Door.

>north
(first opening the Front Door)
You can't, since the Front Door leads nowhere.